########
##     #
#    # #
#p     #
#   #  #
#  ##  #
#  #   #
########