#####333
#      3
# e  2 3
#p     #
#   1  #
#  11  #
#  1   #
########