33333333
3      3
3   2  3
1p     3
1      1
1 a e  1
1      1
11111111