33333333
3ee    3
3ee  2 3
1p     3
1   1  1
1  11  1
1  1   1
11111111