#####333
#      3
#    2 3
#p     #
#   1  #
#  11  #
#  1   #
########