########
#      #
#    1 #
#p     #
#   1  #
#  11  #
#  1   #
########