########
#    # #
#    # #
#p     #
#   #  #
#  ##  #
#  #   #
########