3333333333333333
3              1
3   2  3       1
1p     1   1   1
1 h    1  11   1
1 a e  1       1
11111111       1
1              1
1     1111     1
1     1        1
1  1111        1
1              1
1         323  1
1              1
1              1
1111111111111111