33333333
3e     3
3    2 3
1p     3
1   1  1
1  11  1
1  1   1
11111111