111111111114e411
1        1 g g 1
1  333   1     1
1    3   1     1
1 p  3 g 1     1
1    3ah       1
1111111111111111
1              1
1              1
1              1
1              1
1              1
1              1
1              1
1              1
1111111111111111