3333333333333333
3   3          1
3p             1
1   1   e      1
1111111111111 11
1      1       1
11111111  111111
1              1
1     1111     1
1     1        1
1  1111        1
1              1
1         323  1
1              1
1              1
1111111111111111