1111111111111111
1        g    g1
1  3   3 3  3  1
1      h       4
1p     a     g e
1      h       4
1  3   3 3  3  1
1        g    g1
1111111111111111
1     1111     1
1     1        1
1  1111        1
1              1
1         323  1
1              1
1111111111111111