11111111114e4111
1      1   g   1
1p   1 1       1
111111 1       1
1      1g     g1
1 g    1323 3231
1    g 1       1
1      1   g   1
133 333333     1
1        23333 1
1ah 1          1
11111    233   1
1        3h    1
1 g      3a g  1
1    g         1
1111111111111111